
       
            F            220,       100,   0             

                        EA      ./xpms/e_wall.xpm                   


                    SO     ./xpms/s_wall.xpm

                            C 255,30,0                                      

                        WE              ./xpms/w_wall.xpm           

                NO      ./xpms/n_wall.xpm                
      
       
                         
     
        1111111111111111111111111   
        1000000000110000000000001   
        1011000001110000000000001   
        10010010W0000000000000111   
111111111111000001110000000000001                                  
100000000011000001110111101111111                     
11110111111111011100000010001                  
11110111111111011101010010001                        
11000000110101011100000010001          
10000000000000000000000000001             
10000000000000001101010010001                   
10000001110000011101010010001                       
11110111 1110101 101111110001    
11111111 1111111 111111111111                         
       
           
