
       
            F            220,       100,   0             

                        EA      ./xpms/e_wall.xpm                   


                    SO     ./xpms/s_wall.xpm

                            C 255,30,0                                      

                        WE              ./xpms/w_wall.xpm           

                NO      ./xpms/n_wall.xpm                
      
       
                         
     
        11111111111111
1111111110000000000001
10000000010111111111111
10S00000110000000000001
10000001110111111111111
11111101110000000000001
11111001110111111111111
1111100000000011111
1111111111111111111                     
       
           
