NO ./xpms/n_wall.xpm
SO ./xpms/s_wall.xpm
WE ./xpms/w_wall.xpm                        
EA ./xpms/e_wall.xpm

F 150,75,0
C 0,75,150

           1111111111111111111111111
           1011000000110000000000001
           1011000001110000000000001
           1001000000000000000000111
111111111111000001110000000000001
100000000011N00001110111101111111
11110111111111011100000010001
11110111111111011101010010001
11000000110101011100000010001
10000000000000000000000000001
10000000000000001101010010001
11000001110101011111011110001
11110111 1110101 101111110001
11111111 1111111 111111111111
